####################
#                  #
#                  #
#                  #
#                  #
#  ####            #
#          #####   #
#        ##        #
#     #            #
#   #              #
####################
